10, 10
1, 1, 3, (start position: x, y, direction (counterclockwise))
8, 1, 0, (exit position: x, y, direction (counterclockwise))
1, 1, 1, 1, 1, 1, 1, 1, 1, 1
1, 0, 0, 1, 0, 0, 0, 1, 0, 1
1, 1, 0, 1, 0, 1, 0, 0, 0, 1
1, 1, 0, 1, 0, 1, 1, 1, 1, 1
1, 0, 0, 1, 0, 0, 0, 0, 0, 1
1, 0, 0, 1, 1, 1, 1, 1, 0, 1
1, 0, 0, 0, 0, 0, 0, 0, 0, 1
1, 0, 1, 0, 1, 1, 1, 1, 0, 1
1, 0, 0, 0, 0, 0, 1, 0, 0, 1
1, 1, 1, 1, 1, 1, 1, 1, 1, 1
